111111111111111
1000000000000E1
101110111110101
100010C01000001
101010101010101
100000P00000000
101010101010101
100010001000001
101110111110111
1000000000001C1
111111111111111
