11111111111111111111111111111111
100C000001C000000000011111111111
1011101111101110C110011111111111
10001000100000111000C11111111111
10101010101010100111111111111111
100000P0C00000001000011111111111
1010101010101010C000011111111111
10001000100000001111111111111111
10111011111011100000111111111111
100C000001C000011110C11111111111
10101010101010101000011111111111
100010001000E0000CCCC11111111111
11111111111111111111111111111111
