111111111111111111111111111111111111111111111111111111
100C000001C0000000000000000000000000000000000000000001
1011101111101110C1100000000000000000000000000000000001
10001000100000111000C000000000000000000000000000000001
101010101010101001111000000000000000000000000000000001
100000P0C000000010000111111111000000000000000000000001
1010101010101010C0000111111111111111111111111111111101
100010001000000011111100000000000000000000000000000001
101110111110111000001101111111111111111111111111111111
100C000001C000011110C100000000000000000000000000000001
101010101010101010000111111111111111111111111111111101
100010001000E0000CCCC100000000000000000000000000000001
111111111111111111111101111111111111111111111111111111
111111111111111111111100000000000000000000000000000001
111111111111111111111111111111111111111111111111111101
110000000000000000000000000000000000000000000000000001
110111111111111111111111111111111111111111111111111111
110000000000000000000000000000000000000000000000000001
111111111111111111111111111111111111111111111111111101
100000000000000000000000000000000000000000000000000001
100000000000000000000000000000000000000000000000000001
10CCCCCCCCCCCCCCCCCCCCCCCCCCCCCCCCCCCCCCCCCCCCCCCCCC01
10CCCCCCCCCCCCCCCCCCCCCCCCCCCCCCCCCCCCCCCCCCCCCCCCCC01
10CCCCCCCCCCCCCCCCCCCCCCCCCCCCCCCCCCCCCCCCCCCCCCCCCC01
100000000000000000000000000000000000000000000000000001
111111111111111111111111111111111111111111111111111111
