1111111111111
10001000000C1
1010101111111
1010000E00001
1010101111111
1P101000000C1
1111111111111
